#...............................................#
#...........#########################...........#
#...........:.:.:.:.:.:.:.:.:.:.:.:.:...........#
#...........:.:.:.:.:.:.:.:.:.:.:.:.:...........#
#.......#################################.......#
#.......:.:.:.:.:.:.:.:.:.:.:.:.:.:.:.:.:.......#
#....@..:.:.:.:.:.:.:.:.:.:.:.:.:.:.:.:.:.......#
#################################################