#####################################################
#####################################################
###...............................................###
###...............................................###
###...........#########################...........###
###...........:.:.:.:.:.:.:.:.:.:.:.:.:...........###
###...........:.:.:.:.:.:.:.:.:.:.:.:.:...........###
###.......#################################.......###
###.......:.:.:.:.:.:.:.:.:.:.:.:.:.:.:.:.:.......###
###....@..:.:.:.:.:.:.:.:.:.:.:.:.:.:.:.:.:.......###
#####################################################
#####################################################