####...............................................####
####...........#########################...........####
####...........:.:.:.:.:.:.:.:.:.:.:.:.:...........####
####...........:.:.:.:.:.:.:.:.:.:.:.:.:...........####
####.......#################################.......####
####.......:.:.:.:.:.:.:.:.:.:.:.:.:.:.:.:.:.......####
####....@..:.:.:.:.:.:.:.:.:.:.:.:.:.:.:.:.:.......####
#######################################################